####################################################################
#...........#.S.#...............#...............#..S.#.............#
#...........#...#...............#...............#....#.............#
#...........#...#...............#...............#....#.............#
#...........#...#...............#...............#....#.............#
######D#######D#########D################D##########D###############
#..................................................................#
#..................................................................#
#..................................................................#
#..................................................................#
#########D####################D############################D########
#....................#..............#...............#..............#
#....................#..............#...............#..............#
#....................#..N...........#...............#....N.........#
#....................#........E.....#...............#..............#
####################################################################