##################################################
#S.........#.......................#.............#
#..........#.......STAFF ROOM......#...Director..#
#..........D.......................D.............#
############..........N............#......N......#
#..................................#.............#
#.......############################D#############
#.......#........................................#
#.......D........................................#
#...N...#..........MAIN HALLWAY..................#
#.......#........................................#
#.......#######################D##################
#.............................#..................#
#.......#######################....Secretary.....#
#.......#.....................#..................#
#.......#.....ACCOUNTING......#.........N........#
#...N...D.....................#..................#
#.......#..........N..........####################
#.......#........................................#
#.......#################........................#
#.......................#........................#
#.......................#.........CLASS 5........#
#.......N...............D........................#
#.......................#............N...........#
#.......................#........................#
#.......................#........................#
#.......................##########################
#................................................#
#................................................#
##################################################