##################################################
#S.........#.....................................#
#..Server..#.....................................#
#..........#..........COMPUTER CLASS.............#
############.....................................#
#..........D.................N...................#
#..........#.....................................#
#..........###########################D###########
#................................................#
#................................................#
#.........########################################
#.........#......................................#
#.........#......................................#
#..N......D...........CHEMISTRY LAB..............#
#.........#......................................#
#.........#..................N...................#
#.........#......................................#
#.........########################################
#................................................#
#................................................#
#........####################....................#
#........#........#.........#....................#
#........#..Dark..D..Tools..#....................#
#..N.....#..Room..#.........#.........N..........#
#........#........#.........#....................#
#........####################....................#
#................................................#
#................................................#
#................................................#
##################################################