##################################################
#S.........#.....................................#
#..Archive.#.....................................#
#..........#.....................................#
############.........#############################
#..........D.........#...........................#
#..N.......#.........#...........................#
#..........#.........#...........................#
############.........#.........STAGE.............#
#....................#...........................#
#....................#...........................#
#.......N............#...........................#
#....................#.........ASSEMBLY..........#
#....................#..........HALL.............#
#......###############...........................#
#......#.............#...........................#
#......#..LIBRARY....#..........N................#
#......#.............#...........................#
#......D......N......#...........................#
#......#.............#...........................#
#......#.............#...........................#
#......###############...........................#
#................................................#
#................................................#
#................................................#
#................................................#
#.............N..................................#
#................................................#
#................................................#
##################################################