##################################################
#S.........#.....................................#
#..Guard...D.....................................#
#..........#.....................................#
############.........#############################
#....................#...........................#
#....................#...........................#
#.......N............#...........................#
#....................#...........................#
#....................#...........................#
#..........###########...........................#
#..........#.........#...........................#
#..........D.Cloaks..#............N..............#
#..N.......#.........#...........................#
#..........#.........#...........................#
#..........#....N....#...........................#
############.........#...........................#
#....................#...........................#
#....................#...........................#
#.......##############...........................#
#.......#............#...........................#
#.......D..Storage...#...........................#
#.......#............#...........................#
#.......##############...........................#
#................................................#
#................................................#
#................................................#
#................................................#
#........................E.......................#
##################################################