##################################################
#S.........#.............#.......................#
#..........#...CLASS 1...#.......CLASS 2.........#
#..........D.............D.......................#
############......N......#..........N............#
#........................#.......................#
#.......##########################################
#.......#.........#..............................#
#.......D..Nurse..#..............................#
#...N...#.........#..............................#
#.......###########..............................#
#................................................#
#................................................#
######################D################..........#
#....................#...........................#
#......CLASS 3.......#.......CLASS 4.............#
#....................#...........................#
#.........N..........#..........N................#
#....................#...........................#
######################.......#####################
#............................#...................#
#............................#......TOILETS......#
#............................#...................#
#............N...............D.........N.........#
#............................#...................#
#............................#...................#
#............................#####################
#................................................#
#................................................#
##################################################