##################################################
#..............................................S.#
#................................................#
#................................................#
#..N.............................................#
#.........########################################
#.........#......................................#
#.........D...........WORKSHOP 1.................#
#.........#......................................#
#.........#..................N...................#
#.........########################################
#................................................#
#.........########################################
#.........#......................................#
#.........D...........WORKSHOP 2.................#
#.........#......................................#
#.........#..................N...................#
#.........########################################
#................................................#
#................................................#
#........###########.............................#
#........#.........#.............................#
#........#..SCRAP..D.............................#
#..N.....#.........#...........N.................#
#........###########.............................#
#................................................#
#................................................#
#................................................#
#................................................#
##################################################