##################################################
#..............................................S.#
#................................................#
#................................................#
#.....######################.....................#
#.....#....................#.....................#
#.....#.......MUSIC........#.....................#
#.....#.........ROOM.......#.....................#
#..N..D....................#..........N..........#
#.....#.........N..........#.....................#
#.....#....................#.....................#
#.....######################.....................#
#................................................#
#................................................#
#................................................#
#................................................#
#.........................########################
#.........................#......................#
#...........N.............#.........ART..........#
#.........................D........STUDIO........#
#.........................#......................#
#.........................#..........N...........#
#.........................#......................#
#.........................#......................#
#.........................########################
#................................................#
#................................................#
#................................................#
#................................................#
##################################################