##################################################
#..............................................S.#
#................................................#
#................................................#
#........#########################################
#........#.......................................#
#...N....D...............KITCHEN.................#
#........#.......................................#
#........########################D################
#................................................#
#................................................#
#................................................#
#.........N......................................#
#................................................#
#.......##########################################
#.......#........................................#
#.......#........................................#
#.......#........................................#
#.......#...............CANTEEN..................#
#.......#........................................#
#..N....D...................N....................#
#.......#........................................#
#.......#........................................#
#.......#........................................#
#.......##########################################
#................................................#
#................................................#
#........................E.......................#
#................................................#
##################################################